111111
1P0E01
10C001
1C0011
1001C1
111111
