1111111111111
10010000001C1
1000011111011
1000110000001
1111111111111
