1111111111111
1110000C00001
1C00001110001
1P00011E00C01
1111111111111
