11111111111
111000C0001
1C000111001
1P0011E00C1
11111111111
